rōstra	rōstrōrum n. Pl.; Rednerbühne (auf dem Forum Romanum)
cīvis	cīvis m. (Gen. Pl.: cīvium); Bürger
ager	agrī m.; Acker, Feld
pellere	pellō, pepulī, pulsum; vertreiben
probus	-a, -um; anständig, tüchtig, gut
labōrāre	labōrō, labōravi, labōratum; arbeiten, (+ Abl.:) an etwas leiden
urgēre_	urgeō, ursī drängen, bedrängen
ūnus	-a, -um (Gen. ūnīus, Dat. ūnī) einer
grātia	grātiae f. Dank, Gunst, Beliebtheit
populus	populī m. Volk
lapis	lapidis m. Stein
in	Präp. + Akk. 1. in … (hinein)2. gegen3. nach4. auf
iacere_	iaciō, iēcī werfen
quod	Konj. weil
monēre_	moneō, monuī mahnen, ermahnen;warnen
auris	auris f.(Gen. Pl.: aurium)Ohr
vincere_	vincō, vīcī siegen, besiegen
glōria	glōriae f. Ehre, Ruhm
vērō	Adv. wirklich, tatsächlich
sēdēs	sēdis f. Wohnsitz
lūxuria	lūxuriae f. Genusssucht
avāritia	avāritiae f. Habgier, Geiz
quamdiū? 	wie lange?
opprimere_	opprimō, oppressī unterdrücken
lēx	lēgis f.; Gesetz
accipere_	accipiō, accēpī annehmen, aufnehmen
mūtāre_	mūtō verändern
