cum	Präp. + Abl.; mit, zusammen mit
thermae	thermārum f. Pl; Thermen
prīmum	Adv.; zunächst, zuerst
in	Präp. + Abl.; in, an, auf, bei
toga	togae f.; Toga
vestis	vestis f.; Kleidung
dēpōnere	dēpōnō; ablegen
saepe	Adv.; oft
ē, ex	Präp. + Abl.; aus (… heraus), von
īre	eō, iī; gehen
septimus	-a, -um; der siebte
hōra	hōrae f.; Stunde
autem	Konj.; aber
silentium	silentiī n.; Stille, Schweigen
iūcundus	-a, -um; angenehm, erfreulich
paucī	-ae, -a Pl.; wenige, nur wenige
aqua	aquae f.; Wasser
nihil	nichts
cōgitāre	cōgitō; denken
at	Konj.; aber
vōx	vōcis f.; Stimme
excitāre	excitō; aufschrecken, aufwecken
patrōnus	patrōnī m.; Schutzherr, Patron
sermō	sermōnis m.; Gespräch
cōnsilium	cōnsiliī n.; Rat, Beratung
occupātus	-a, -um; beschäftigt
molestus	-a, -um; lästig, unangenehm
sēcum	bei sich
aestās	aestātis f.; Sommer
errāre	errō; irren, sich irren
longē	Adv.; weit
ā, ab	Präp. + Abl.; von
