secūtor	secūtōris m.; Verfolger (ein bestimmter Gladiator)
ille	ille m., illa f., illud n. Dem.-Pron.; jener, der dort
porta	portae f.; Tor, Pforte
rētiārius	rētiāriī m.; Netzkämpfer (ein bestimmter Gladiator)
arēna	arēnae f.; Arena (Kampfplatz im Amphitheater)
hic	hic m., haec f., hoc n. Dem.-Pron.; dieser, der hier
gladiātor	gladiātōris m.; Gladiator
īgnōtus	a, -um; unbekannt
valdē	Adv.; sehr
arma	armōrum n. Pl.; Waffen
gladius	gladiī m.; Schwert
pūgnāre	pūgnō, pūgnāvi, pūgnātum; kämpfen
petere	petō, petīvī, petītum; angreifen, aufsuchen, fordern, (er)bitten
nōmen	nōminis n.; Name
dēfendere	dēfendō, dēfendī, dēfēnsum; verteidigen
atque	Konj.; und
cadere	cadō, cecidī, _; fallen
humī	auf dem Boden
iacēre	iaceō; liegen
rūrsus	Adv.; wieder, von neuem
iactāre	iactō, iactāvi, iactātum; werfen, schleudern
in	Präp. + Akk.; 1. in (… hinein) 2. gegen
intendere	intendō; (gegen jdn.) richten
neque	Konj.; und nicht
pūgna	pūgnae f.; Kampf
iūdicium	iūdiciī n.; Urteil, Meinung
aspicere	aspiciō; ansehen
aliī	-ae, -a Pl.; andere
mittere	mittō, mīsī, missum; schicken, wegschicken
vīvere	vīvō, vīvī; leben
